11110000
0I000000
00000000
00000000
00000000
00000100
00001000
0100000X
